1111111111111111111111111111111111
100000000000000000000000000X000001
1010010100100000101001000000010101
1010010010101010001001000E00010101
1P0000000C00C000000000000000000001
1111111111111111111111111111111111