1111111111111
1001000C00C01
1000011111C01
1P0011E000001
1111111111111