1111111111111111111111111111111111
1000X000000000000000000000000X0001
10100101001000001010010000X0010101
101001001011010X00100100E000010101
100000000C000000000000000000000001
100000000C000000000000000000000001
100000000C000000000000000000000001
100000000C000000000000000000000001
100000000C0000000000000000000P0001
1111111111111111111111111111111111