1111111111111111111111111111111111
100000000000000C00000C000000000001
1010010100100000001001000000010101
101001001010100E001001000000010101
1P0000000C00C0000000000000000000C1
1111111111111111111111111111111111