1111111111111111111111111111111111
100000000000000000000000000X000001
1010010100100000101001000000010101
101001001011010C00100100E000010101
10P0000000000000000000000000000001
1111111111111111111111111111111111