111111111111
100P0C000001
111111111111