1111111111
10PCEa0001
1111111111