111111111111111111111111
100P00000C000X000E000001
111111111111111111111111